NO TEX/prova.xpm
SO TEX/hitler.xpm
EA TEX/protoblue.xpm
WE TEX/switches.xpm


F 127, 127, 127
C 135, 206, 250
111111
1100N1
111111
