NO TEX/bricks.xpm
SO TEX/hitler.xpm
EA TEX/protoblue.xpm
WE TEX/switches.xpm

F 100, 120, 50
C 135, 206, 250

111111111111111111111111111111111111
111111111111111111111111111111111111
100000000000000011111111111111111111
100000000000000011111111111111111111
100000000000000000000000000000000011
100000000000000011111111111111111111
100000000000000000000000000000000011
100000000000000011111111111111111111
100000000000000000000000000000000011
111111111000000000000000000000000011
100000000000000000000000000000000011
1111111110000000000000N0000000000011
100000000000000000000000000000000011
111111111000000000000000000000000011
111111111111111111111111111111111111
111111111111111111111111111111111111